
現在手機的拍照功能已經很精進了，甚至都有光學防手震跟拍RAW檔了	positive
比方PanasonicCM1，有1吋感光元件，鏡頭也經過Leica認證，還有獨立影像處器，相機規格非常夢幻	positive
拍風景或拉近拍，線條清晰度或立體感還是沒有很夠	negative
在外型上都給人厚重的感覺，而一加X將厚度壓在6.9mm、重量只有138g，對於喜愛小手機的人來說，還蠻有吸引力	positive
Snapdragon801這顆處理器一般很少會過熱	positive
以2525mAh容量的電池來看，續航表現還算不錯	positive
相機細部畫質仍有很大進步空間	negative
背蓋上有刷一些髮絲紋，算有顧到一點視覺美觀，有做出一點弧邊，手感還不錯	positive
在陽光下自動亮度感應調整的速度有點慢	negative
拍照時對焦跟測光可以分開點擊，這還蠻方便的	positive
當手機兩三天沒整理或重開機，操作就開始有變慢	negative
延續G4的強大相機功能、手動模式與Raw檔，新加入了手動錄影模式、三鏡頭錄影的短片模式功能	positive
雖然質感上與各家比較起來還是略差	negative
由於機身尺寸比較大而且偏重(192g)，要單手操作時會比較困難	negative
用單手截圖(電源鍵＋音量降低鍵)時不像以前這麼好按	negative
儲存速度也令人滿意，幾乎在按下快門的瞬間，就完成儲存的動作	positive
V10的前相機廣角比起G4勝出	positive
自動模式拍夜景畫質會比較差	negative
嚴格來說，跟今年的主流旗艦機比較起來，效能表現不算好	negative
在安兔兔的穩定性測試中，溫度變化只有2度，溫度控制處理的很好	positive
綜合性能強悍	positive
遊戲性能出色	positive
跟今年旗艦手機比起來速度偏慢	negative
測出來的結果都顯示V10續航力不佳	negative
我在測試時發現，LG的指紋辨識建立過程，比其它品牌還要慢，過程要花比較長的時間	negative
手動相機模式外，還加入了廣角120度自拍、手動錄影模式與短片模式，尤其錄影功能更強大	positive
外型質感不佳，整體看起來塑膠感較為明顯	negative
192g的重量也是偏重	negative
喇叭音量跟G4比起來明顯較小外放品質跟以往手機一樣不甚理想	negative
搭配鏡頭內的步進式對焦馬達，能夠讓ZenFoneZoom達到0.03秒內就能完成的自動對焦，小編實際使用的確非常快	positive
Nexus6P是此歷代質感最好的一款	positive
測試期間溫度最低31.5度、最高38度，相差只有6.5度而已，顯見華為宣稱優化散熱確實有達到成效	positive
在規格上其實相當有誠意	positive
其中3D繪圖只有6392分並不算高，若是要玩大型3D遊戲Adreno405可能有點不足	negative
G7Plus的指紋辨識速度很快，而且比Mate7更穩定	positive
聽音樂的體驗也不錯，看影片時前置雙喇叭效果很有感，環繞感、音量都夠	positive
支援降噪耳機聽音樂，隔噪音的效果很好	positive
續航力表現很不錯	positive
相對在HTC家續航力比較好	positive
整體而言M9+極光版在拍照體驗方面更勝一籌	positive
A9與M9+極光版毫無疑問是目前HTC最強的兩款照相手機	positive
這兩支日拍的體驗都很好	positive
A9的自拍依舊維持高水準	positive
合成出來的精選影片還蠻無聊	negative
我覺得HTC的音樂App是所有Android廠商中做得做好的	positive
全畫面的動感視效播放，畫面呈現很絢麗	positive
溫度控制做得很不錯	positive
手指很容易擋住鏡頭位置	negative
HTC相信以OneA9的條件，在同資費手機裡是很有競爭力的	positive
很遺憾已拿掉原本內建的音樂功能	negative
現場試聽喇叭的音量有點弱	negative
在室外測試時螢幕也十分清晰	positive
立體音效還是有一定的水準	positive
整體規格是進步蠻多的	positive
紅色款蝴蝶機給人喜氣的感覺，拿在手上時也十分搶眼	positive
蝴蝶機在台灣的智慧型手機歷史上，可以列入傳奇神機了	positive
霧面塗裝設計，可減少指紋的沾染	positive
銳利度或是色彩飽和度都有不錯的效果	positive
導入了自家相機產品線的影像處理技術，讓照相品質更上一層樓	positive
支援降噪功能，減少環境雜音	positive
簡約但重視細節的精緻化設計可以感受到企圖讓使用Sony手機成為一種生活風格的用心	positive
將過去亮面的玻璃材質改為霧面，除了更有簡約美感外更有不易沾染指紋的優點	positive
由SONYα相機團隊操刀設計的相機設計也是Z5最大的賣點	positive
4K螢幕讓銳利度更好、對比度提高、色彩更鮮豔	positive
機身背面有微微的彎曲弧度，握感還不錯	positive
觸感上就像是磨砂紙一樣粗粗的，個人不是很喜歡	negative
竹質背蓋竹質的配色與觸感是我最喜歡的，握在手中有清涼感	positive
感應解鎖的速度的確很快	positive
OneME的對焦速度、啟動速度都還不錯	positive
錄影時畫質還蠻不穩定	negative
自動模式拍出來的照片明顯偏暗	negative
近拍時雖然確定有對到焦，不過輸出後的照片還是會覺得有點糊，感覺成像不夠立體	negative
9在整體效能上還是最好	positive
室內黃光下白平衡不穩	negative
耗電的速度很快	negative
M812把底下NFC的位置很明顯標出，很直接但對美感來說有點突兀了	negative
拍出的照片其實是沒對到焦的，這裡有點困擾	negative
使用起來的順暢度比最初的Z3+好很多	positive
這個位置對解鎖手機來說真還蠻順手的	positive
旗艦機這方面表現都不差了	positive
指紋解鎖體驗也很順	positive
鏡面的缺點就是非常容易留下指紋	negative
在輸入法當中，拇指也無法輕鬆按到所有的按鍵	negative
相機仍然凸出機身一截，破壞了整體的美觀性	negative
透過電腦或是OTG隨身碟傳檔案時，會明顯感受到效率極佳	positive
單手操作變得不容易	negative
價格跟市面上Android旗艦機相比確實偏貴	 negative
用的是現在很流行的淡金色，氣質剛好，不會太高調	positive
背面側邊還是有做一點弧度，並不會有刮手的感覺	positive
大手機起來較俐落有現代感，會比較有型	positive
開啟速度還不錯	positive
比眼睛看起來要飽和一點，但是討喜的顏色	positive
直覺跟方便度來說，這裡可以再加強吧	negative
如果要按音量鍵拿橫著單手拍，也是可但手勢會覺得有點不順	negative
按壓下去的反饋感還不錯	positive
美顏後的皮膚色澤也很討喜	positive
昏暗環境下感光明顯較市面上大部份手機好	positive
在正常明亮的光線下，對焦速度的確是蠻快的	positive
在家裡或室內透過內建喇叭觀賞影片時，爽度大為增加	positive
表層沒有抗污處理，很容易留下指紋跟油汙	negative


