
發生零件接觸不良	negative
呈現很燙狀態	negative
使用上頓頓的	negative
雙擊喚醒失效	negative
外殼會裂	negative
直接死機	negative
備料不足	negative
黑白兩色最耐看	positive
卡了一堆污垢	negative
淺色系比較好看	positive
背蓋密合度不佳	negative
皮的無線充電背蓋，還不錯	positive
v10耗電較凶	negative
整體來說算滿意	positive
常常雙卡都在繞圈圈	negative
上網時會斷訊	negative
Lg接收訊號弱	negative
講電話時燙燙的	negative
背殼質感很好	positive
續航力頗悲劇	negative
非常省電！	positive
耗電依然是用噴的	negative
鏡頭的鏡片品質不好	negative
黑色的蠻有質感的	positive
成像整個糊糊	negative
按鍵鬆鬆的	negative
通話清晰	positive
對不到焦	negative
輸入法真的超爛	negative
溫度很容易升高	negative
自拍前鏡頭很優	positive
高畫素又大光圈	positive
主鏡頭也不弱	positive
儲存空間悲劇	negative
稍微光線不足就馬上油畫感	negative
看中防手震	positive
質感好棒啊	positive
UI友善	positive
夜拍跟本悲劇	negative
照相不能靜音	negative
組裝質感可圈可點	positive
包覆性很好	positive
記憶體夠大	positive
機背霧面削光整個質感很棒!	positive
防指紋且耐髒	positive
握感真的是不錯	positive
造型是我愛的!	positive
大光圈真的很好用	positive
速度慢的真誇張	negative
手機反應順暢	positive
順暢度感覺跟以往一樣順暢 ~	positive
手機超燙~~	negative
省電提升許多	positive
一秒內就可以解鎖。	positive
拍照錄影功能完整	positive
明顯發現漏光	negative
像機功能太過陽春	negative
隨心所欲買電池蓋直接換	positive
耗電量嚇人	negative
續航不算優	negative
太過豔麗	negative
顏色很不飽滿	negative
異常耗電	negative
耗電控制的相當不錯	positive
溫度都很容易上升	negative
需要每天充電	negative
充電超級慢	negative
髮絲紋，質感真的很棒	positive
單手就能指紋辨識解鎖	positive
喇叭很小聲	negative
使用相當輕鬆	positive
指紋很廢	negative
超有科技感	positive
真的很容易糊掉	negative
做工細緻	positive
手感很舒適	positive
手紋不易留	positive
金屬質感讓整體加分	positive
開螢幕就噴電	negative
待機很省電	positive
反應速度很快	positive
螢幕灰灰的	negative
這價位cp值爆表啊～～	positive
畫質更漂亮	positive
耗電量增加	negative
這應該省電到爆吧!	positive
聲音很乾淨	positive
喇叭破音的聲音	positive
規格也算是最頂尖的	positive
螢幕漏光	negative
測試錄影就有雜音	negative
螢幕顏色不飽滿	negative
照相功能挺弱的	negative
對焦 不知道對哪邊	negative
UI 不夠直覺	negative
輸入法很不人性化	negative
使用上 頓頓的 沒有很順暢。	negative
電力非常夠。	positive
喇叭非常大聲。	positive
窄邊框設計的挺漂亮	positive
