
配色也相當不錯	positive
顏色條的很不錯	positive
紮紮實實的全金屬打造	positive
充電效率變高	positive
最好握的金屬機	positive
聲音通透感不錯	positive
按鍵回饋感都十分清脆好按	positive
按鍵回饋感都十分好按	positive
介面變漂亮	positive
音樂也變好聽	positive
記憶體卻提升到3G Ram	positive
順暢度是絕對足夠的	positive
GPS定位也是秒定	positive
戶外拍攝的水準不錯	positive
高光低光都有不錯的表現	positive
內建的濾鏡十分有FU	positive
拍攝的能力算強	positive
拍攝效果變得相當好	positive
感光度提高	positive
超精美的外型	positive
設計成圓形的音量鍵還滿古錐的	positive
機子背面的細紋很漂亮	positive
機子很輕很薄	positive
UI介面設計的很好	positive
不會有多餘的操作設計	positive
這價格CP值很高	positive
電池容易膨脹到壞掉	positive
沒有跟新Android的服務	positive
電池很大使用一整天不用行動電源都沒問題	positive
支援4G 	positive
CP值大勝	positive
UI還挺順暢的	positive
規格不錯	positive
WIFI會斷線	positive
外形不喜歡	positive
播音樂有時會卡一下	positive
藍芽也是會斷斷續續	positive
手感不錯	positive
金屬機身	positive
大小剛剛好	positive
錄製 4K UHD 超高畫質影片	positive
指紋辨識掃瞄速度更快	positive
可拍攝色彩更鮮明動人且低雜訊的照片	positive
玫瑰金真的很美	positive
IPHONE的保值期也長	positive
比市面上便宜	positive
螢幕畫素提高	positive
設計輕薄	positive
電池容量比上一代更大	positive
選擇R7S其中原因就是閃充 真的很方便	positive
電池又大	positive
雙卡雙待	positive
手機質感真的不錯	positive
整體設計都超好的	positive
無敵的快充	positive
照相真的太強大了	positive
oppo還是很划算的	positive
上一隻是拿R7，使用上還蠻順手	positive
in810用了兩年多還是非常順暢	positive
堅固耐用	positive
速度又快	positive
攝影功能很強	positive
電池大	positive
螢幕大	positive
功能也很實用	positive
硬體方面是好手機	positive
系統很順暢	positive
成相不錯	positive
很超值的一隻手機	positive
運行很順暢	positive
內建的程式有很多實用的功能	positive
可換電池	positive
大螢幕	positive
電池續航力不錯	positive
前鏡頭不錯	positive
買了M210，便宜好用	positive
溫度有點高導致遊戲當機	negative
gps信號蠻飄的	negative
可惜的是後續的新機都有沒有加入光學防震	negative
FB常閃退	negative
軟體沒有寫得很好	negative
R7S小工具部分常常會當掉無法使用	negative
軟體寫的滿差的	negative
記憶體常會在80%導致打不開app	negative
訊號變更差	negative
某些狀況下touch 好像會突然失效	negative
電還是噴得好快	negative
感覺看起來機身很厚	negative
內建的瀏覽器使用一段時間會有時候閃退	negative
聽音樂關屏時會斷斷續續	negative
夜拍不行	negative
不支援4G	negative
機軟體寫得真的不是很穩定	negative
CPU容易過熱當機	negative
wifi 收訊比較容易在長距離的AP斷線	negative
聽筒聲音對老人家來說可能會過小	negative
順暢度其實不算好	negative
在餐廳內拍照後進入圖片庫看照片很暗	negative
照相的快門聲音太小	negative
對焦速度就降下來	negative
測光需加強	negative
低光源下會顯得模糊	negative
iPhone 6的天線很醜	negative
電池很爛	negative