
照相品質有提升	positive
照片的畫質不錯	positive
電池蓋的設計真的很爛	negative
面版質感不錯	positive
CPU速度慢	negative
相機開啟超慢無比	negative
內建記憶體少得可憐	negative
撥電話的操作介面超智慧	negative
耗電量過快	negative
內建的軟體已經很豐富	positive
這台機子的硬體效能頗佳	positive
螢幕很棒	positive
鈴聲聲音夠響亮	positive
鈴聲大小普通	negative
gps定位速度蠻快的	positive
外型有質感	positive
穩定性還蠻好的	positive
相容性很好	positive
1080P的螢幕真的不是蓋的	positive
設計上很有巧思	positive
超耗電	negative
CP值算高了	positive
機身質感好棒	positive
設計還蠻有時尚感的	positive
螢幕漂亮	positive
爆高的C/P值	positive
錄影好像使用720P 會不太穩	negative
LG原廠ROM爆爛	negative
螢幕沒那麼漂亮	negative
處理效能真的很差	negative
質感一流	positive
螢幕是曲面的也太屌了吧	positive
這台最讓我滿意的就是外型	positive
待機時間也有夠長	positive
4K的影片放在手機裡播放，非常流暢	positive
出乎想像的輕薄	positive
觸控反應最流暢的手機之一	positive
耳機輸出的功率似乎有點小	negative
音質普通	negative
電池很有力	positive
續航力蠻強大	positive
螢幕畫質漂亮到沒話說	positive
螢幕看起來就是舒服	positive
喜歡它的輕薄機身	positive
WIFI收訊真的比較弱	negative
拍照也還不差	positive
指紋辨識很靈敏	positive
相機和網路上說的一樣讚	positive
便宜的價格	positive
順暢度完勝其他幾隻	positive
相機功能專業模式很強大	positive
整體起來還算滿意	positive
介面相當流暢	positive
價格死硬	negative
手機畫面太漂亮	positive
首頁啟動速度似乎慢了些	negative
中文輸入按鍵小	negative
充電速度算快了	positive
拍照速度比較快	positive
對焦慢	negative
拍照太廢	negative
超高c/p值	positive
收訊明顯有待加強	negative
信號都非常穩定	positive
尺寸不錯	positive
換電池時背蓋好像不是很好用	negative
耳筒話音清晰	positive
機身溫度不高	positive
觸控功能我認為是非常靈敏的	positive
CP值爆表	positive
電池續航力ok	positive
手機的感光度很強耶	positive
自動亮度效果不優	negative
機身紮實	positive
app質感佳	positive
續航力優	positive
指紋辨識功能方便迅速	positive
太貴了	negative
開機慢	negative
後鏡相機素質大進步	positive
充電速度超級無敵快	positive
容易耗電	negative
瀏覽器使用順暢	positive
電量有點少	negative
通話品質就不太好	negative
邊框聽說叫做玫瑰金，很漂亮	positive
手感就是差了那麼一點點	negative
拍照介面也是SONY的比較好用	positive
開啟相機的速度很令人驚艷	positive
相機也無法自動對焦	negative
影片播放不順暢	negative
軟體一直有問題	negative
拍照功能似乎又更強大了	positive
飽和度仍然不錯	positive
HTC金屬好質感	positive
背蓋金色的不算很有質感	negative
螢幕顯示效果也很好	positive
滑個多工畫面會頓	negative
拍照差了點	negative
重量很不錯	positive